תמר - מעיין כהן
מעיין כהן - איתן הילמן
איתן הילמן - מיטב
מיטב - איתי לויכטר
איתי לויכטר - מיה
מיה - יהודה
יהודה - ישי שארף
ישי שארף - שיר
שיר - ליה
ליה - בועז
בועז - רועי
רועי - אלה
אלה - אמונה
אמונה - הלל פורת
הלל פורת - אביגיל
אביגיל - רננה
רננה - פרג
פרג - הדר
הדר - יואבי
יואבי - אלעד
אלעד - יואב מ
יואב מ - שירה קפש
שירה קפש - עינב
עינב - שקד
שקד - אביב
אביב - מתן
מתן - קרקר
קרקר - אוריין
אוריין - אריאל
אריאל - שירה דוד
שירה דוד - תירוש
תירוש - שניר
שניר - מעיין אדלר
מעיין אדלר - תמר
